DDDDDDDDDDDDDDDDDDDDDDD
DNNNNNNNNNNNNNNNNNNNNND
DNNNNNNNNNNNNNNNNNNNNND
DNNNNNNNNNNNNNNNNNNNNND
DNNNNNNNNNNNNNNNNNNNNND
DNNNNNNNNNllNNNNNNNNNND
DNNNNNNNNNllNNNNNNNNNND
DNNNNNNNNNNNNNNNNNNNNND
DNNNNNNNNNNNNNNNNNNNNND
DNNNNNNNNNNNNNNNNNNNNND
DNNNNNNNNNNPNNNNNNNNNND
DDDDDDDDDDDDDDDDDDDDDDD