111111111111111111111111111111111111111111111111111111111111
10000000000000000000000000JJ000000GGGGGGGGGGGGGGGGGGGGGGGGG1
10WWWWWWWWWWW000000LL00J00JJ00000GGMMMMM7MMMMMMMMMWWWWWMWWG1
10WBKSSSTIAIW000000000L00000000L0GMMMMMMMMMV9MMMMMMMSSS9SWG1
10WSSSSSSSSSW0000JJ000000GGGGGG00GMMMVMMMMMMMMM6VMWSCMSSSWG1
10WWWWW5WWWWW0000JJ00JJ0GGMMMVGG0GMMMMMMMM9MMMM2MMWWMW5WWMG1
10F0000UPH00F00000000JJGGMVV9MMG0GMM6MMMCMMMMYM7MMMMMMYM7MG1
10FFFFFUFFFFF0000000000GMMVVMMMG0GMMMMMMMMMMMMMYYYYYYYMMMMG1
1000000UU00000000000000GGMMMMMGG0GMMXXXXXXMMMMYYYMMMMMMMMMG1
10000000UU0000000C000000GGGcGGG00GMMM8M68MMMMMYYMMMMMMMMMMG1
100000000UU000000000000LL000ZZZZ0GVMMMMMMMMMMVMYYM9MMMMMMMG1
100000JJ0UU0000000GGG00000ZZZZZZ0GMMMMMM9MMMMYYYYMMMMMMMMMG1
100L00JJ0UU00ZZ000GMG0000ZZZZZZZ0GMM78MMM8MMMMYYYMMMMMMMMMG1
10JJ00000UU00ZZ000GGG0000ZZZZZZZ0GGMQQQQQQMMMMMMYYYMMMMMMMG1
10JJ0000UU0000000000000JJ000000000GMMMMMMMMMMMMMMYYMMVMMMGG1
100000JJUU000000J000000JJ000000000GGGGGGGMMMMMMMMYYMMMMGGG01
100000JJUUUL0000UUUUUU000UUUUUUUUUUUUUUUGGGGGGGGGYYGGGGG0001
100L00000UUUUUUUUUUUUUUUUUUUGGGGGUUGGGUUUUUUUUUUUUUUUUU00001
10000000UU0JJLGGYYGGGGGGGGGGGMMMGGGGMGG000000UUU000JJ0000001
1000000UU00JJGGMYYMMMMMMMMMMMMMMMMMMMMG0JJ00UU00000JJ0000001
1000L0UU0JJ00GMMYYMMMMMMMMMMM2MWWWWMMMG0JJ00UU0000000000JJ01
100LL0UU0JJ0GGMYYMMMMMMMVMMMM7SSMSWMVMG00000UU0000H0H000JJ01
100000UU000GGMMYYMMMMMMMMCMMMMMWSWWMMMGG0000UUUUUUUUUUUUU001
10000UU0000GMMYYMMMMMMMMMMMMMCMMSSWMMMMG0000UUUZZZZZZZZ0UU01
100000UU000GMMYYYYYYYYYMMMMMMMMS7SWMM2MG0000UUZZZZZZZZZZ0UU1
1JJ0000UU00GMM2MMMYYYYYYMMMMM2MSSMSMMMMG0000UUZZZZZZZZZZZUU1
1JJZZ00UU00GMMMMMMMMMMMMMMMMMMMMMWWWMMMG0000UUZZZZZZZZZZZUU1
10ZZZ0UUJJ0GGMMMMMMMVMMMMMMMMMMVMMMMMMGG0000UU0ZZZZZZZZZ0UU1
10ZZZ000JJ00GGGGGGGGGGGGGGGGGGGGGGGGGGG000000UUUUUUUUUUUUU01
111111111111111111111111111111111111111111111111111111111111