1111111111111111111111111111
1111100000000000001101000001
1000000001110000000000010001
11000000000000100100PCE00011
1000000000000000000000010001
1111111111111111111111111111
