11111
1PCE1
1111111111
1PCE1
1111111111
1PCE1
1111111111
1PCE1
1111111111
1PCE1
1111111111
1PCE1
1111111111
1PCE1
1111111111
1PCE1
1111111111
1PCE1
1111111111
1PCE1
1111111111
1PCE1
1111111111
1PCE1
1111111111
1PCE1
11111
