111111111111111111111111111111111111111111111111111111111111
1C0000000000000000000000000000000000GGGGGGGGGGGGGGGGGGGGGGG1
10WWWWWWWWWWWWWWW00000000000000000GGGMMM7MMMMMMMMMWWWWWMWWG1
10WBKSSSSSSSSASTW000ZZZZZ000JJ000GGMMVVMMMMVMMMMVVMMSSSSSWG1
10WSSSSSSSSSSISSWJJ0ZZZZZ000JJ000GMMMVVMMMMMMMM6VVWSCMSSSWG1
10WSSSSSSSSSSSSSWJJ0000ZZ0000000GGMMMYYYYYYYMMM2MMWWMW5WWMG1
10WTSSSSSSSSSSSTWF000JJ000000JJ0GMMM6MMMMYYYYYM7MYYYYYYM7MG1
10WWWWWWWEWWWWWWW0000JJ000000JJ0GMMMMMMMMMMMYYYYYYMMMMMVMMG1
10F000CP0U0H0L00F00000000000J000GGMMXXXXXXMMMMYYYMMMMMMMMMG1
10F000000U000000FL000000000000000GVVM8M68MMMMVVYYMMMMMMMMMG1
10FFFFFFUUUFFFFFF000000LL000ZZZZ0GVVMYYYYYYMMVVYYM2MMMCMMMG1
100000JJ0UU0000000GGG00000ZZZZZZ0GMMYYYYYYYYYYYYYMMMMMMMMMG1
100L00JJ0UU00ZZ000GMG0000ZZZZZZZ0GMM78MCM8MYYYYYYMMMMMMMMMG1
10JJ00000UU00ZZ000GGG0000ZZZZZZZ0GGMQQQQQQMMMMMMYYYMMVVMMMG1
10JJ0000UU0000000000000JJ000000000GMMMMMMMMMMMMMMYYMMVVMMGG1
100000JJUU000000J000000JJ000000000GGGGGGGMMMMMMMMYYMMMMGGG01
100000JJUUUL0000UUUUUU000UUUUUUUUUUUUUUUGGGGGGGGGYYGGGGG0001
100L00000UUUUUUUUUUUUUUUUUUUGGGGGUUGGGUUUUUUUUUUUUUUUUU00001
10000000UU0JJLGGYYGGGGGGGGGGGMMMGGGGMGG000000UUU000JJ0000001
1000000UU00JJGGMYYMMMMMMMMMMMMMMMMMMMMG0JJ00UU00000JJ0000001
1000L0UU0JJ00GMMYYMMMMMMVVMMMMMWWWWMVVG0JJ00UU0000000000JJ01
100LL0UU0JJ0GGMYYMMMMMMMVVMMMMSSMSWMVVG00000UU0000H0H000JJ01
100000UU000GGMMYYMMMMMMMMMMMMMMWSWWMMMGG0000UUUUUUUUUUUUU001
10000UU0000GMMYYMMMMMMMMMMMMMMMMSSWMMMMG0000UUUZZZZZZZZ0UU01
100000UU000GMMYYYYYYYYYYYYYMMMMSMSWMMMMG0000UUZZZZZZZZZZ0UU1
1JJ0000UU00GMM2MMMYYYYYYYYYYM2MSSMSMMMMG0000UUZZZZZZZZZZZUU1
1JJZZ00UU00GMMMMMMMMMMMMMMMMMMMVVWWWMMMG0000UUZZZZZZZZZZZUU1
10ZZZ0UU000GGMMMMMMMVMMMMMMMCMMVVMMMMMGG0000UUZZZZZZZZZZZUU1
10ZZZ000JJ00GMMMMMMMMMMMMMMMMMMMMMMMMGG00000UU0ZZZZZZZZZ0UU1
10000000JJ00GGGGGGGGGGGGGGGGGGGGGGGGGG0000000UUUUUUUUUUUU0C1
111111111111111111111111111111111111111111111111111111111111
