111111111111111111111111111111111111111111111111111111111111
1C00000000000000000000FFFFF000000000GGGGGGGGGGGGGGGGGGGGGGG1
10WWWWWWWWWWWWWWW000000000F0000000GGGMMM7MMMMMMMMMWWWWWMWWG1
10WBKSSSSSSSSASTW000ZZZZZ000JJ000GGMMVVMMMMVMMMMVVMMSSSSSWG1
10WSSSSSSSSSSISSWJJ0ZZZZZ000JJ000GMMMVVMMMMMMMM6VVWSCMSSSWG1
10WSSSSSSSSSSSSSWJJ0000ZZ0000000GGMMMYYYYYYYMMMMMMWWMW5WWMG1
10WTSSSSSSSSSSSTWF000JJ000000JJ0GMMM6MMMMYYYYYM7MYYYYYYM7MG1
10WWWWWWWEWWWWWWW0000JJ000000JJ0GMMMMMMMMMMMYYYYYYMMMMMVMMG1
10F000CP0U0H0L00F00000000000J000GGMMXXXXXXMMMMYYYMMMMMMMMMG1
10F000000U000000FL000000000000000GVVM8M68MMMMVVYYMMMMMMMMMG1
10FFFFFFUUUFFFFFF000000LL000ZZZZ0GVVMYYYYYYMMVVYYMMMMMCMMMG1
100000JJ0UU0000000GGG00000ZZZZZZ0GMMYYYYYYYYYYYYYMMMMMMMMMG1
100000JJ0UU00ZZ000GMG0000ZZZZZZZ0GMM78MCM8MYYYYYYMMMMMMMMMG1
100000000UU00ZZ000GGG0000ZZZZZZZ0GGMQQQQQQMMMMMMYYYMMVVMMMG1
10000000UU0000000000000JJ000000000GMMMMMMMMMMMMMMYYMMVVMMGG1
100000JJUU000000J000000JJ000000000GGGGGGGMMMMMMMMYYMMMMGGG01
100000JJUUUL0000UUUUUU000UUUUUUUUUUUUUUUGGGGGGGGGYYGGGGG0001
100L00000UUUUUUUUUUUUUUUUUUUGGGGGUUGGGUUUUUUUUUUUUUUUUU00001
10000GGGGGGGGGGGYYGGGGGGGGGGGMMMGGGGMGG000000UUU000JJ0000001
100GGGMMMMMMMMMMYYMMMMMMMMMMMMMMMMMMMMG0JJ00UU00000JJ0000001
10GGMMMMMMVVMMMMYYMMMMMMVVMMMMMWWWWMVVG0JJ0UU00000000000JJ01
1GGMMMMMMMVVMMMYYMMMMMMMVVMMMMSSMSWMVVG00000UU00UUUUUU00JJ01
1GMMMVVMMMMMMMMYYMMMMMMMMMMMMMMMWSWWMMG000000UUUUUUUUUUUU001
1GMMMVVMMMMVMMMYYMMMMMMMMMMMMMMMMSSWMMGG0000UUUZZZZZZZZ0UUU1
1GMMMMMMMMMMMMMYYYYYYYYYYYYYMMMMSMSWMMMG0000UUZZZZZZZZZZ0UU1
1GMMMMMMMMMMMM2MMMYYYYYYYYYYMMMSSMSMMMMG0000UUZZZZZZZZZZZUU1
1GMMMVMMMMVVMMMMMMMMMMMMMMMMMMMVVWWWMMMG0000UUZZZZZZZZZZZUU1
1GMMMMCMMMVVMMMMMMMMVMMMMMMMCMMVVMMMMMGG0000UUZZZZZZZZZZZUU1
1GMMMMMMMMMMMMMMMMMMMMMMMMMMMMMMMMMMMGG00000UU0ZZZZZZZZZ0UU1
1GGGGGGGGGGGGGGGGGGGGGGGGGGGGGGGGGGGGG0000000UUUUUUUUUUUU0C1
111111111111111111111111111111111111111111111111111111111111
